1011  1010  1100  1011  1010  1010  1010  1100  
1001  1010  0110  1001  1010  1010  1010  0100  
0001  1100  1001  0110  1001  1100  1011  0110  
0101  0101  0001  1010  0110  0011  1010  1100  
0001  0110  0011  1010  1100  1001  1110  0101  
0011  1000  1010  1100  0011  0110  1001  0110  
1001  0000  1110  0101  1001  1100  0011  1100  
0111  0011  1010  0010  0110  0011  1010  0110  
